Country/Territory,Region,C/T?,Edition,Status,PR_Rating,CL_Rating,A,B,C,Add_Q,Add_A,PR,D,E,F,G,CL,Total
Abkhazia,Eurasia,t,2007,PF,5,5,5,5,3,0,0.0,13,8,4,4,5,21,34
Afghanistan,Asia,c,2007,PF,5,5,6,7,4,0,0.0,17,5,5,3,5,18,35
Albania,Europe,c,2007,PF,3,3,8,11,7,0,0.0,26,11,8,10,9,38,64
Algeria,MENA,c,2007,NF,6,5,4,4,3,0,0.0,11,7,6,5,7,25,36
Andorra,Europe,c,2007,F,1,1,12,15,12,0,0.0,39,16,11,15,15,57,96
Angola,SSA,c,2007,NF,6,5,2,5,1,0,0.0,8,8,6,4,3,21,29
Antigua and Barbuda,Americas,c,2007,F,2,2,11,12,7,0,0.0,30,13,9,12,13,47,77
Argentina,Americas,c,2007,F,2,2,11,15,7,0,0.0,33,14,11,10,13,48,81
Armenia,Eurasia,c,2007,PF,5,4,4,5,4,0,0.0,13,8,5,6,9,28,41
Australia,Asia,c,2007,F,1,1,12,15,12,0,0.0,39,16,12,14,15,57,96
Austria,Europe,c,2007,F,1,1,12,16,12,0,0.0,40,16,12,15,15,58,98
Azerbaijan,Eurasia,c,2007,NF,6,5,3,4,3,0,0.0,10,7,3,4,8,22,32
Bahamas,Americas,c,2007,F,1,1,12,16,10,0,0.0,38,16,12,15,15,58,96
Bahrain,MENA,c,2007,PF,5,5,3,9,4,0,0.0,16,8,3,4,5,20,36
Bangladesh,Asia,c,2007,PF,4,4,8,10,4,0,0.0,22,8,8,6,9,31,53
Barbados,Americas,c,2007,F,1,1,12,16,12,0,0.0,40,16,12,16,15,59,99
Belarus,Eurasia,c,2007,NF,7,6,0,3,1,0,0.0,4,3,0,2,5,10,14
Belgium,Europe,c,2007,F,1,1,12,16,12,0,0.0,40,16,12,15,15,58,98
Belize,Americas,c,2007,F,1,2,12,14,10,0,0.0,36,15,11,12,13,51,87
Benin,SSA,c,2007,F,2,2,10,15,8,0,0.0,33,15,12,12,10,49,82
Bhutan,Asia,c,2007,NF,6,5,3,1,5,1,2.0,10,7,2,4,8,21,31
Bolivia,Americas,c,2007,PF,3,3,11,13,4,0,0.0,28,15,11,8,9,43,71
Bosnia and Herzegovina,Europe,c,2007,PF,3,3,8,11,6,0,0.0,25,11,8,10,10,39,64
Botswana,SSA,c,2007,F,2,2,11,11,9,0,0.0,31,14,10,13,10,47,78
Brazil,Americas,c,2007,F,2,2,11,14,6,0,0.0,31,15,10,8,12,45,76
Brunei,Asia,c,2007,NF,6,5,0,3,3,0,1.0,7,6,3,6,8,23,30
Bulgaria,Europe,c,2007,F,1,2,12,15,9,0,0.0,36,14,11,12,12,49,85
Burkina Faso,SSA,c,2007,PF,5,3,5,8,4,0,0.0,17,14,9,6,8,37,54
Burundi,SSA,c,2007,PF,4,5,9,9,4,0,0.0,22,8,5,4,6,23,45
Cambodia,Asia,c,2007,NF,6,5,3,5,3,0,0.0,11,9,6,2,7,24,35
Cameroon,SSA,c,2007,NF,6,6,3,5,3,0,0.0,11,7,3,2,4,16,27
Canada,Americas,c,2007,F,1,1,12,16,12,0,0.0,40,16,12,15,16,59,99
Cape Verde,SSA,c,2007,F,1,1,12,15,10,0,0.0,37,15,11,14,13,53,90
Central African Republic,SSA,c,2007,PF,5,4,7,7,3,0,0.0,17,10,9,3,4,26,43
Chad,SSA,c,2007,NF,6,6,3,1,2,0,0.0,6,7,5,1,3,16,22
Chechnya,Eurasia,t,2007,NF,7,7,0,0,0,0,0.0,0,4,0,0,2,6,6
Chile,Americas,c,2007,F,1,1,12,15,12,0,0.0,39,16,12,15,15,58,97
China,Asia,c,2007,NF,7,6,0,1,1,0,0.0,2,4,2,2,7,15,17
Colombia,Americas,c,2007,PF,3,3,10,9,7,0,0.0,26,12,7,7,10,36,62
Comoros,SSA,c,2007,PF,3,4,9,11,4,0,0.0,24,10,6,8,6,30,54
Congo (Brazzaville),SSA,c,2007,NF,6,5,3,5,3,0,0.0,11,9,7,2,6,24,35
Congo (Kinshasa),SSA,c,2007,NF,5,6,6,6,2,0,0.0,14,6,5,0,1,12,26
Costa Rica,Americas,c,2007,F,1,1,12,15,11,0,0.0,38,16,11,13,13,53,91
Cote d'Ivoire,SSA,c,2007,NF,7,6,1,2,2,0,0.0,5,5,4,3,4,16,21
Croatia,Europe,c,2007,F,2,2,12,14,9,0,0.0,35,14,12,11,13,50,85
Cuba,Americas,c,2007,NF,7,7,0,0,1,0,0.0,1,2,1,1,2,6,7
Cyprus,Europe,c,2007,F,1,1,11,16,11,0,0.0,38,15,12,15,15,57,95
Czech Republic,Europe,c,2007,F,1,1,12,15,11,0,0.0,38,16,12,14,15,57,95
Denmark,Europe,c,2007,F,1,1,12,16,12,0,0.0,40,16,12,15,15,58,98
Djibouti,SSA,c,2007,PF,5,5,4,5,3,0,0.0,12,7,5,5,6,23,35
Dominica,Americas,c,2007,F,1,1,12,16,10,0,0.0,38,16,12,13,13,54,92
Dominican Republic,Americas,c,2007,F,2,2,11,13,9,0,0.0,33,15,11,10,11,47,80
Ecuador,Americas,c,2007,PF,3,3,9,15,4,0,0.0,28,15,11,5,10,41,69
Egypt,MENA,c,2007,NF,6,5,1,4,2,0,0.0,7,6,2,5,7,20,27
El Salvador,Americas,c,2007,F,2,3,12,13,8,0,0.0,33,15,9,7,10,41,74
Equatorial Guinea,SSA,c,2007,NF,7,6,0,1,0,0,0.0,1,5,0,1,3,9,10
Eritrea,SSA,c,2007,NF,7,6,0,1,2,0,0.0,3,2,0,2,6,10,13
Estonia,Europe,c,2007,F,1,1,12,15,12,0,0.0,39,16,12,14,14,56,95
Ethiopia,SSA,c,2007,PF,5,5,5,5,4,0,0.0,14,7,3,4,6,20,34
Fiji,Asia,c,2007,PF,6,4,0,5,2,0,0.0,7,10,4,7,10,31,38
Finland,Europe,c,2007,F,1,1,12,16,12,0,0.0,40,16,12,16,16,60,100
France,Europe,c,2007,F,1,1,12,15,11,0,0.0,38,15,12,14,15,56,94
Gabon,SSA,c,2007,PF,6,4,2,5,3,0,0.0,10,10,6,6,5,27,37
Georgia,Eurasia,c,2007,PF,3,3,9,9,7,0,0.0,25,12,8,7,10,37,62
Germany,Europe,c,2007,F,1,1,12,15,12,0,0.0,39,15,12,15,15,57,96
Ghana,SSA,c,2007,F,1,2,12,15,10,0,0.0,37,14,11,12,10,47,84
Greece,Europe,c,2007,F,1,2,12,15,10,0,0.0,37,15,10,14,13,52,89
Grenada,Americas,c,2007,F,1,2,12,16,9,0,0.0,37,15,9,11,14,49,86
Guatemala,Americas,c,2007,PF,3,4,9,10,5,0,0.0,24,12,8,5,8,33,57
Guinea,SSA,c,2007,NF,6,5,2,5,2,0,0.0,9,8,5,4,6,23,32
Guinea-Bissau,SSA,c,2007,PF,4,4,9,9,4,0,0.0,22,11,8,8,6,33,55
Guyana,Americas,c,2007,F,2,3,11,13,7,0,0.0,31,15,10,8,9,42,73
Haiti,Americas,c,2007,PF,4,5,7,10,3,0,0.0,20,10,5,2,5,22,42
Honduras,Americas,c,2007,PF,3,3,9,10,6,0,0.0,25,13,8,7,9,37,62
Hong Kong,Asia,t,2007,PF,5,2,3,7,6,0,0.0,16,14,10,14,13,51,67
Hungary,Europe,c,2007,F,1,1,12,15,10,0,0.0,37,16,12,13,14,55,92
Iceland,Europe,c,2007,F,1,1,12,16,12,0,0.0,40,16,12,16,16,60,100
India,Asia,c,2007,F,2,3,11,14,9,0,0.0,34,13,10,9,10,42,76
Indian Kashmir,Asia,t,2007,PF,5,5,6,6,3,0,0.0,15,8,6,3,8,25,40
Indonesia,Asia,c,2007,F,2,3,11,13,6,0,0.0,30,10,9,7,9,35,65
Iran,MENA,c,2007,NF,6,6,3,4,3,0,0.0,10,4,2,3,4,13,23
Iraq,MENA,c,2007,NF,6,6,7,6,1,3,0.0,11,4,3,0,4,11,22
Ireland,Europe,c,2007,F,1,1,12,16,11,0,0.0,39,16,12,15,15,58,97
Israel,MENA,c,2007,F,1,2,12,15,10,0,0.0,37,14,12,10,11,47,84
Israeli Occupied Territories,MENA,t,2007,NF,6,5,3,3,3,1,0.0,8,6,5,1,5,17,25
Italy,Europe,c,2007,F,1,1,12,15,11,0,0.0,38,15,12,12,15,54,92
Jamaica,Americas,c,2007,F,2,3,10,13,8,0,0.0,31,15,9,8,11,43,74
Japan,Asia,c,2007,F,1,2,12,15,10,0,0.0,37,13,10,15,13,51,88
Jordan,MENA,c,2007,PF,5,4,3,6,5,0,0.0,14,9,5,6,8,28,42
Kazakhstan,Eurasia,c,2007,NF,6,5,3,4,3,0,0.0,10,7,4,4,7,22,32
Kenya,SSA,c,2007,PF,3,3,9,11,5,0,0.0,25,14,9,8,8,39,64
Kiribati,Asia,c,2007,F,1,1,12,16,8,0,0.0,36,15,12,15,13,55,91
Kosovo,Eurasia,t,2007,PF,6,5,6,5,3,0,3.0,11,7,6,4,7,18,29
Kuwait,MENA,c,2007,PF,4,4,4,9,6,0,0.0,19,9,6,7,5,27,46
Kyrgyzstan,Eurasia,c,2007,PF,5,4,5,7,4,0,0.0,16,10,8,5,7,30,46
Laos,Asia,c,2007,NF,7,6,0,1,0,0,0.0,1,4,1,2,5,12,13
Latvia,Europe,c,2007,F,1,1,12,15,9,0,0.0,36,16,12,12,13,53,89
Lebanon,MENA,c,2007,PF,5,4,4,8,5,0,0.0,17,12,8,5,9,34,51
Lesotho,SSA,c,2007,F,2,3,9,12,9,0,0.0,30,15,8,11,9,43,73
Liberia,SSA,c,2007,PF,3,4,9,10,5,0,0.0,24,11,7,7,8,33,57
Libya,MENA,c,2007,NF,7,7,0,1,0,0,0.0,1,1,0,0,6,7,8
Liechtenstein,Europe,c,2007,F,1,1,12,16,12,0,0.0,40,16,12,16,16,60,100
Lithuania,Europe,c,2007,F,1,1,12,15,9,0,0.0,36,16,11,14,13,54,90
Luxembourg,Europe,c,2007,F,1,1,12,16,12,0,0.0,40,16,12,16,16,60,100
Macedonia,Europe,c,2007,PF,3,3,7,10,7,0,0.0,24,11,7,8,10,36,60
Madagascar,SSA,c,2007,PF,4,3,7,9,7,0,0.0,23,10,8,9,9,36,59
Malawi,SSA,c,2007,PF,4,3,7,10,6,0,0.0,23,11,8,9,7,35,58
Malaysia,Asia,c,2007,PF,4,4,6,7,6,0,0.0,19,8,6,6,9,29,48
Maldives,Asia,c,2007,NF,6,5,3,4,4,0,0.0,11,6,3,7,7,23,34
Mali,SSA,c,2007,F,2,2,9,12,9,0,0.0,30,16,9,10,9,44,74
Malta,Europe,c,2007,F,1,1,12,16,11,0,0.0,39,16,12,16,15,59,98
Marshall Islands,Asia,c,2007,F,1,1,12,15,10,0,0.0,37,16,11,15,13,55,92
Mauritania,SSA,c,2007,PF,5,4,6,7,4,0,0.0,17,10,8,6,5,29,46
Mauritius,SSA,c,2007,F,1,2,11,15,11,0,0.0,37,15,12,13,12,52,89
Mexico,Americas,c,2007,F,2,3,10,14,9,0,0.0,33,14,10,8,11,43,76
Micronesia,Asia,c,2007,F,1,1,12,15,10,0,0.0,37,16,11,15,14,56,93
Moldova,Eurasia,c,2007,PF,3,4,9,8,7,0,0.0,24,10,6,8,9,33,57
Monaco,Europe,c,2007,F,2,1,10,11,10,0,0.0,31,15,12,15,14,56,87
Mongolia,Asia,c,2007,F,2,2,8,15,10,0,0.0,33,15,10,12,12,49,82
Montenegro,Europe,c,2007,PF,3,3,9,9,6,0,0.0,24,12,10,8,11,41,65
Morocco,MENA,c,2007,PF,5,4,4,7,6,0,0.0,17,8,6,6,8,28,45
Mozambique,SSA,c,2007,PF,3,4,7,11,7,0,0.0,25,11,7,7,8,33,58
Myanmar,Asia,c,2007,NF,7,7,0,1,0,3,0.0,-2,2,0,0,4,6,4
Nagorno-Karabakh,Eurasia,t,2007,PF,5,5,6,5,3,0,0.0,14,8,4,4,5,21,35
Namibia,SSA,c,2007,F,2,2,10,12,9,0,0.0,31,15,12,10,9,46,77
Nauru,Asia,c,2007,F,1,1,12,16,10,0,0.0,38,15,11,15,14,55,93
Nepal,Asia,c,2007,PF,5,4,4,9,4,0,0.0,17,9,6,6,7,28,45
Netherlands,Europe,c,2007,F,1,1,12,16,12,0,0.0,40,16,12,15,16,59,99
New Zealand,Asia,c,2007,F,1,1,12,15,12,0,0.0,39,16,11,15,15,57,96
Nicaragua,Americas,c,2007,PF,3,3,11,12,5,0,0.0,28,14,8,7,10,39,67
Niger,SSA,c,2007,PF,3,3,11,10,8,0,0.0,29,11,9,9,6,35,64
Nigeria,SSA,c,2007,PF,4,4,6,9,6,0,0.0,21,11,7,5,7,30,51
North Korea,Asia,c,2007,NF,7,7,0,0,0,0,0.0,0,0,0,0,1,1,1
Northern Cyprus,Europe,t,2007,F,2,2,11,14,9,0,0.0,34,13,9,12,12,46,80
Norway,Europe,c,2007,F,1,1,12,16,12,0,0.0,40,16,12,16,16,60,100
Oman,MENA,c,2007,NF,6,5,2,2,2,0,4.0,10,6,3,4,5,18,28
Pakistan,Asia,c,2007,NF,6,5,2,6,3,0,0.0,11,8,6,4,6,24,35
Pakistani Kashmir,Asia,t,2007,NF,7,5,2,3,2,2,0.0,5,6,4,4,6,20,25
Palau,Asia,c,2007,F,1,1,12,15,10,0,0.0,37,16,11,15,13,55,92
Palestinian Authority Administered Territories,MENA,t,2007,PF,4,6,6,9,3,0,0.0,18,5,5,1,5,16,34
Panama,Americas,c,2007,F,1,2,12,15,9,0,0.0,36,15,11,9,12,47,83
Papua New Guinea,Asia,c,2007,PF,3,3,9,11,6,0,0.0,26,12,9,7,8,36,62
Paraguay,Americas,c,2007,PF,3,3,11,11,4,0,0.0,26,12,8,7,10,37,63
Peru,Americas,c,2007,F,2,3,11,14,7,0,0.0,32,15,9,8,9,41,73
Philippines,Asia,c,2007,PF,3,3,7,13,8,0,0.0,28,14,9,8,10,41,69
Poland,Europe,c,2007,F,1,1,12,16,10,0,0.0,38,15,11,13,14,53,91
Portugal,Europe,c,2007,F,1,1,12,16,12,0,0.0,40,16,12,15,14,57,97
Puerto Rico,Americas,t,2007,F,1,1,12,15,10,0,0.0,37,16,11,14,14,55,92
Qatar,MENA,c,2007,NF,6,5,2,1,3,0,3.0,9,8,2,4,4,18,27
Romania,Europe,c,2007,F,2,2,11,14,7,0,0.0,32,14,11,12,12,49,81
Russia,Eurasia,c,2007,NF,6,5,3,5,3,0,0.0,11,8,4,4,7,23,34
Rwanda,SSA,c,2007,NF,6,5,3,3,4,0,0.0,10,7,3,6,7,23,33
Samoa,Asia,c,2007,F,2,2,9,13,10,0,0.0,32,14,10,13,12,49,81
San Marino,Europe,c,2007,F,1,1,12,16,12,0,0.0,40,16,12,16,16,60,100
Sao Tome and Principe,SSA,c,2007,F,2,2,11,14,8,0,0.0,33,15,10,12,10,47,80
Saudi Arabia,MENA,c,2007,NF,7,6,0,0,1,0,3.0,4,4,0,3,2,9,13
Senegal,SSA,c,2007,F,2,3,11,13,9,0,0.0,33,15,10,9,9,43,76
Serbia,Europe,c,2007,F,3,2,9,13,7,0,0.0,29,14,11,9,13,47,76
Seychelles,SSA,c,2007,PF,3,3,8,10,7,0,0.0,25,10,9,11,11,41,66
Sierra Leone,SSA,c,2007,PF,4,3,9,10,4,0,0.0,23,12,8,8,9,37,60
Singapore,Asia,c,2007,PF,5,4,4,6,7,0,0.0,17,9,3,8,12,32,49
Slovakia,Europe,c,2007,F,1,1,12,15,10,0,0.0,37,16,12,12,14,54,91
Slovenia,Europe,c,2007,F,1,1,12,15,11,0,0.0,38,15,12,14,12,53,91
Solomon Islands,Asia,c,2007,PF,4,3,6,10,7,0,0.0,23,13,9,8,12,42,65
Somalia,SSA,c,2007,NF,7,7,0,0,1,0,0.0,1,3,0,0,0,3,4
South Africa,SSA,c,2007,F,2,2,12,14,9,0,0.0,35,15,12,12,12,51,86
South Korea,Asia,c,2007,F,1,2,11,15,10,0,0.0,36,14,12,13,12,51,87
Spain,Europe,c,2007,F,1,1,12,15,12,0,0.0,39,16,12,14,15,57,96
Sri Lanka,Asia,c,2007,PF,4,4,8,8,7,0,0.0,23,8,9,6,10,33,56
St. Kitts and Nevis,Americas,c,2007,F,1,1,12,16,10,0,0.0,38,15,12,12,14,53,91
St. Lucia,Americas,c,2007,F,1,1,12,16,10,0,0.0,38,15,12,12,14,53,91
St. Vincent and the Grenadines,Americas,c,2007,F,2,1,11,15,8,0,0.0,34,15,11,13,14,53,87
Sudan,SSA,c,2007,NF,7,7,0,4,3,4,0.0,3,4,3,0,0,7,10
Suriname,Americas,c,2007,F,2,2,12,13,7,0,0.0,32,15,11,9,10,45,77
Swaziland,SSA,c,2007,NF,7,5,0,1,1,0,1.0,3,8,3,4,5,20,23
Sweden,Europe,c,2007,F,1,1,12,16,12,0,0.0,40,16,12,16,16,60,100
Switzerland,Europe,c,2007,F,1,1,12,16,12,0,0.0,40,16,12,15,16,59,99
Syria,MENA,c,2007,NF,7,6,0,0,1,0,0.0,1,2,0,1,5,8,9
Taiwan,Asia,c,2007,F,2,1,10,15,9,0,0.0,34,16,11,15,13,55,89
Tajikistan,Eurasia,c,2007,NF,6,5,2,4,3,1,0.0,8,6,4,4,6,20,28
Tanzania,SSA,c,2007,PF,4,3,6,10,6,0,0.0,22,11,7,10,8,36,58
Thailand,Asia,c,2007,NF,7,4,0,1,3,0,0.0,4,10,5,6,11,32,36
The Gambia,SSA,c,2007,PF,5,4,6,7,4,0,0.0,17,10,6,7,8,31,48
Tibet,Asia,t,2007,NF,7,7,0,0,1,3,0.0,-2,0,0,0,5,5,3
Timor-Leste,Asia,c,2007,PF,3,4,11,10,5,0,0.0,26,11,7,6,9,33,59
Togo,SSA,c,2007,NF,6,5,2,4,2,0,0.0,8,7,5,3,6,21,29
Tonga,Asia,c,2007,PF,5,3,3,9,3,0,0.0,15,12,5,11,12,40,55
Transnistria,Eurasia,t,2007,NF,6,6,2,4,1,0,0.0,7,6,2,2,5,15,22
Trinidad and Tobago,Americas,c,2007,F,2,2,9,13,9,0,0.0,31,15,11,10,13,49,80
Tunisia,MENA,c,2007,NF,6,5,1,3,2,0,0.0,6,4,2,4,8,18,24
Turkey,Europe,c,2007,PF,3,3,9,12,7,0,0.0,28,12,7,8,10,37,65
Turkmenistan,Eurasia,c,2007,NF,7,7,0,0,0,0,0.0,0,1,0,0,0,1,1
Tuvalu,Asia,c,2007,F,1,1,12,15,10,0,0.0,37,16,12,15,14,57,94
Uganda,SSA,c,2007,PF,5,4,4,7,4,0,0.0,15,11,6,7,7,31,46
Ukraine,Eurasia,c,2007,F,3,2,9,13,6,0,0.0,28,13,10,11,11,45,73
United Arab Emirates,MENA,c,2007,NF,6,5,1,1,2,0,4.0,8,6,3,4,4,17,25
United Kingdom,Europe,c,2007,F,1,1,12,16,12,0,0.0,40,16,12,15,15,58,98
United States,Americas,c,2007,F,1,1,11,16,11,0,0.0,38,16,10,14,15,55,93
Uruguay,Americas,c,2007,F,1,1,12,16,11,0,0.0,39,16,12,15,15,58,97
Uzbekistan,Eurasia,c,2007,NF,7,7,0,0,0,0,0.0,0,1,0,0,2,3,3
Vanuatu,Asia,c,2007,F,2,2,9,15,8,0,0.0,32,16,11,10,11,48,80
Venezuela,Americas,c,2007,PF,4,4,8,8,4,0,0.0,20,11,7,5,8,31,51
Vietnam,Asia,c,2007,NF,7,5,0,1,1,0,0.0,2,5,2,4,8,19,21
Western Sahara,MENA,t,2007,NF,7,6,0,0,0,2,0.0,-2,3,2,0,5,10,8
Yemen,MENA,c,2007,PF,5,5,4,7,3,0,0.0,14,7,3,4,5,19,33
Zambia,SSA,c,2007,PF,3,4,8,11,6,0,0.0,25,11,8,8,7,34,59
Zimbabwe,SSA,c,2007,NF,7,6,1,3,0,0,0.0,4,5,2,1,1,9,13
