Country/Territory,Region,C/T?,Edition,Status2013,PR_Rating,CL_Rating,A,B,C,Add_Q,Add_A,PR,D,E,F,G,CL,Score2013
Abkhazia,Eurasia,t,2013,PF,4,5,7,7,4,0,0.0,18,8,5,4,5,22,40
Afghanistan,Asia,c,2013,NF,6,6,3,6,2,0,0.0,11,6,5,2,3,16,27
Albania,Europe,c,2013,PF,3,3,8,10,6,0,0.0,24,13,8,9,9,39,63
Algeria,MENA,c,2013,NF,6,5,4,4,3,0,0.0,11,7,5,5,7,24,35
Andorra,Europe,c,2013,F,1,1,12,15,12,0,0.0,39,16,11,15,15,57,96
Angola,SSA,c,2013,NF,6,5,4,6,1,0,0.0,11,8,4,4,3,19,30
Antigua and Barbuda,Americas,c,2013,F,2,2,11,13,7,0,0.0,31,14,9,13,13,49,80
Argentina,Americas,c,2013,F,2,2,11,14,6,0,0.0,31,14,11,11,13,49,80
Armenia,Eurasia,c,2013,PF,5,4,5,5,3,0,0.0,13,8,6,6,9,29,42
Australia,Asia,c,2013,F,1,1,12,15,12,0,0.0,39,16,12,15,15,58,97
Austria,Europe,c,2013,F,1,1,12,15,11,0,0.0,38,16,12,15,15,58,96
Azerbaijan,Eurasia,c,2013,NF,6,5,1,3,2,0,0.0,6,4,2,4,7,17,23
Bahamas,Americas,c,2013,F,1,1,12,16,10,0,0.0,38,16,12,15,15,58,96
Bahrain,MENA,c,2013,NF,6,6,3,2,3,2,0.0,6,3,2,1,6,12,18
Bangladesh,Asia,c,2013,PF,3,4,9,11,5,0,0.0,25,9,7,6,9,31,56
Barbados,Americas,c,2013,F,1,1,12,16,12,0,0.0,40,16,12,16,15,59,99
Belarus,Eurasia,c,2013,NF,7,6,0,3,1,0,0.0,4,3,1,1,5,10,14
Belgium,Europe,c,2013,F,1,1,12,16,12,0,0.0,40,15,12,15,15,57,97
Belize,Americas,c,2013,F,1,2,12,14,11,0,0.0,37,15,11,12,13,51,88
Benin,SSA,c,2013,F,2,2,8,16,8,0,0.0,32,15,12,13,10,50,82
Bhutan,Asia,c,2013,PF,4,5,8,8,7,1,0.0,22,8,3,5,8,24,46
Bolivia,Americas,c,2013,PF,3,3,11,11,7,0,0.0,29,14,10,7,9,40,69
Bosnia and Herzegovina,Europe,c,2013,PF,3,3,8,11,6,0,0.0,25,10,7,10,10,37,62
Botswana,SSA,c,2013,F,3,2,10,10,8,0,0.0,28,13,10,12,11,46,74
Brazil,Americas,c,2013,F,2,2,11,14,8,0,0.0,33,15,10,10,13,48,81
Brunei,Asia,c,2013,NF,6,5,0,3,3,0,1.0,7,6,3,6,8,23,30
Bulgaria,Europe,c,2013,F,2,2,11,15,8,0,0.0,34,14,11,11,11,47,81
Burkina Faso,SSA,c,2013,PF,5,3,5,8,4,0,0.0,17,13,8,7,8,36,53
Burundi,SSA,c,2013,PF,5,5,4,6,2,0,0.0,12,8,4,4,6,22,34
Cambodia,Asia,c,2013,NF,6,5,3,3,3,0,0.0,9,9,3,2,6,20,29
Cameroon,SSA,c,2013,NF,6,6,2,3,2,0,0.0,7,7,3,2,4,16,23
Canada,Americas,c,2013,F,1,1,12,16,12,0,0.0,40,16,11,15,16,58,98
Cape Verde,SSA,c,2013,F,1,1,12,15,10,0,0.0,37,15,11,14,13,53,90
Central African Republic,SSA,c,2013,PF,5,5,7,7,2,0,0.0,16,8,4,3,4,19,35
Chad,SSA,c,2013,NF,7,6,3,1,1,0,0.0,5,7,4,2,3,16,21
Chile,Americas,c,2013,F,1,1,12,15,12,0,0.0,39,16,11,15,15,57,96
China,Asia,c,2013,NF,7,6,0,1,2,1,0.0,2,4,3,2,6,15,17
Colombia,Americas,c,2013,PF,3,4,10,10,7,0,0.0,27,12,5,7,10,34,61
Comoros,SSA,c,2013,PF,3,4,9,11,5,0,0.0,25,10,6,8,6,30,55
Congo (Brazzaville),SSA,c,2013,NF,6,5,1,3,3,0,0.0,7,8,6,2,6,22,29
Congo (Kinshasa),SSA,c,2013,NF,6,6,3,4,2,0,0.0,9,7,3,0,1,11,20
Costa Rica,Americas,c,2013,F,1,1,12,15,11,0,0.0,38,16,11,13,13,53,91
Cote d'Ivoire,SSA,c,2013,PF,5,5,5,4,4,0,0.0,13,8,5,4,4,21,34
Croatia,Europe,c,2013,F,1,2,12,15,9,0,0.0,36,14,12,11,13,50,86
Cuba,Americas,c,2013,NF,7,6,0,0,1,0,0.0,1,2,0,2,6,10,11
Cyprus,Europe,c,2013,F,1,1,11,16,11,0,0.0,38,15,11,15,14,55,93
Czech Republic,Europe,c,2013,F,1,1,12,15,11,0,0.0,38,16,12,14,15,57,95
Denmark,Europe,c,2013,F,1,1,12,16,12,0,0.0,40,16,12,15,15,58,98
Djibouti,SSA,c,2013,NF,6,5,3,3,3,0,0.0,9,7,3,4,6,20,29
Dominica,Americas,c,2013,F,1,1,12,16,10,0,0.0,38,15,12,15,15,57,95
Dominican Republic,Americas,c,2013,F,2,2,10,12,9,0,0.0,31,15,10,8,11,44,75
Ecuador,Americas,c,2013,PF,3,3,7,11,6,0,0.0,24,13,7,6,10,36,60
Egypt,MENA,c,2013,PF,5,5,3,10,3,0,0.0,16,8,5,4,8,25,41
El Salvador,Americas,c,2013,F,2,3,12,14,9,0,0.0,35,15,8,9,10,42,77
Equatorial Guinea,SSA,c,2013,NF,7,7,0,1,0,0,0.0,1,4,0,0,3,7,8
Eritrea,SSA,c,2013,NF,7,7,0,0,1,0,0.0,1,0,0,0,2,2,3
Estonia,Europe,c,2013,F,1,1,12,15,12,0,0.0,39,16,12,14,14,56,95
Ethiopia,SSA,c,2013,NF,6,6,1,2,4,0,0.0,7,3,0,3,5,11,18
Fiji,Asia,c,2013,PF,6,4,0,5,2,0,0.0,7,11,3,6,10,30,37
Finland,Europe,c,2013,F,1,1,12,16,12,0,0.0,40,16,12,16,16,60,100
France,Europe,c,2013,F,1,1,12,15,11,0,0.0,38,15,12,15,15,57,95
Gabon,SSA,c,2013,NF,6,5,2,4,3,0,0.0,9,10,4,6,5,25,34
Gaza Strip,MENA,t,2013,NF,6,6,5,2,2,0,0.0,9,4,3,0,3,10,19
Georgia,Eurasia,c,2013,PF,3,3,7,10,7,0,0.0,24,12,7,7,10,36,60
Germany,Europe,c,2013,F,1,1,12,15,12,0,0.0,39,15,12,15,15,57,96
Ghana,SSA,c,2013,F,1,2,12,15,10,0,0.0,37,14,11,12,10,47,84
Greece,Europe,c,2013,F,2,2,12,15,8,0,0.0,35,14,11,10,13,48,83
Grenada,Americas,c,2013,F,1,2,12,16,10,0,0.0,38,15,11,12,13,51,89
Guatemala,Americas,c,2013,PF,3,4,9,10,5,0,0.0,24,12,7,6,8,33,57
Guinea,SSA,c,2013,PF,5,5,5,8,2,0,0.0,15,9,6,4,5,24,39
Guinea-Bissau,SSA,c,2013,NF,6,5,2,5,0,0,0.0,7,10,5,3,5,23,30
Guyana,Americas,c,2013,F,2,3,11,13,7,0,0.0,31,15,9,7,9,40,71
Haiti,Americas,c,2013,PF,4,5,5,9,5,0,0.0,19,10,5,4,5,24,43
Honduras,Americas,c,2013,PF,4,4,6,8,4,0,0.0,18,11,6,7,9,33,51
Hong Kong,Asia,t,2013,PF,5,2,3,7,6,0,0.0,16,14,9,15,13,51,67
Hungary,Europe,c,2013,F,1,2,12,15,9,0,0.0,36,15,12,11,14,52,88
Iceland,Europe,c,2013,F,1,1,12,16,12,0,0.0,40,16,12,16,16,60,100
India,Asia,c,2013,F,2,3,11,14,9,0,0.0,34,13,11,8,10,42,76
Indian Kashmir,Asia,t,2013,PF,4,4,8,8,4,0,0.0,20,9,6,6,8,29,49
Indonesia,Asia,c,2013,F,2,3,11,13,6,0,0.0,30,12,9,5,9,35,65
Iran,MENA,c,2013,NF,6,6,2,2,2,0,0.0,6,2,1,3,4,10,16
Iraq,MENA,c,2013,NF,6,6,7,4,1,1,0.0,11,5,4,0,4,13,24
Ireland,Europe,c,2013,F,1,1,12,16,11,0,0.0,39,16,12,15,15,58,97
Israel,MENA,c,2013,F,1,2,12,14,10,0,0.0,36,12,11,11,11,45,81
Italy,Europe,c,2013,F,2,1,11,15,9,0,0.0,35,15,12,12,14,53,88
Jamaica,Americas,c,2013,F,2,3,12,13,8,0,0.0,33,15,9,6,10,40,73
Japan,Asia,c,2013,F,1,2,12,15,10,0,0.0,37,13,10,15,13,51,88
Jordan,MENA,c,2013,NF,6,5,2,5,3,0,0.0,10,7,3,6,8,24,34
Kazakhstan,Eurasia,c,2013,NF,6,5,2,3,1,0,0.0,6,5,3,4,8,20,26
Kenya,SSA,c,2013,PF,4,4,6,10,5,0,0.0,21,13,8,6,7,34,55
Kiribati,Asia,c,2013,F,1,1,12,16,8,0,0.0,36,15,12,15,13,55,91
Kosovo,Europe,c,2013,PF,5,4,6,8,3,1,0.0,16,8,6,5,7,26,42
Kuwait,MENA,c,2013,PF,5,5,2,10,5,0,0.0,17,7,4,7,6,24,41
Kyrgyzstan,Eurasia,c,2013,PF,5,5,6,6,4,2,0.0,14,9,5,4,7,25,39
Laos,Asia,c,2013,NF,7,6,0,0,0,0,0.0,0,4,0,2,5,11,11
Latvia,Europe,c,2013,F,2,2,12,14,7,0,0.0,33,15,12,12,12,51,84
Lebanon,MENA,c,2013,PF,5,4,5,9,3,0,0.0,17,11,7,5,9,32,49
Lesotho,SSA,c,2013,F,2,3,10,13,8,0,0.0,31,14,7,11,9,41,72
Liberia,SSA,c,2013,PF,3,4,9,11,6,0,0.0,26,11,8,7,8,34,60
Libya,MENA,c,2013,PF,4,5,9,10,3,0,0.0,22,8,6,1,6,21,43
Liechtenstein,Europe,c,2013,F,1,1,12,15,12,0,0.0,39,16,12,15,16,59,98
Lithuania,Europe,c,2013,F,1,1,12,16,9,0,0.0,37,16,11,13,13,53,90
Luxembourg,Europe,c,2013,F,1,1,12,16,12,0,0.0,40,16,12,16,16,60,100
Macedonia,Europe,c,2013,PF,3,3,8,11,7,0,0.0,26,11,8,8,11,38,64
Madagascar,SSA,c,2013,PF,6,4,1,5,1,0,0.0,7,9,7,5,7,28,35
Malawi,SSA,c,2013,PF,3,4,8,11,7,0,0.0,26,11,7,9,7,34,60
Malaysia,Asia,c,2013,PF,4,4,6,8,6,0,0.0,20,9,5,5,9,28,48
Maldives,Asia,c,2013,PF,5,4,7,6,4,0,0.0,17,7,7,7,8,29,46
Mali,SSA,c,2013,NF,7,5,1,3,2,1,0.0,5,8,4,3,4,19,24
Malta,Europe,c,2013,F,1,1,12,16,11,0,0.0,39,16,12,15,15,58,97
Marshall Islands,Asia,c,2013,F,1,1,11,15,10,0,0.0,36,16,11,15,13,55,91
Mauritania,SSA,c,2013,NF,6,5,3,3,5,0,0.0,11,10,4,4,5,23,34
Mauritius,SSA,c,2013,F,1,2,12,15,11,0,0.0,38,15,12,13,12,52,90
Mexico,Americas,c,2013,PF,3,3,9,12,7,0,0.0,28,13,8,6,10,37,65
Micronesia,Asia,c,2013,F,1,1,12,15,10,0,0.0,37,16,11,15,14,56,93
Moldova,Eurasia,c,2013,PF,3,3,11,12,6,0,0.0,29,11,8,8,9,36,65
Monaco,Europe,c,2013,F,2,1,10,11,10,0,0.0,31,15,12,15,14,56,87
Mongolia,Asia,c,2013,F,1,2,11,16,9,0,0.0,36,15,11,12,12,50,86
Montenegro,Europe,c,2013,F,3,2,9,11,7,0,0.0,27,13,10,10,12,45,72
Morocco,MENA,c,2013,PF,5,4,5,7,4,0,0.0,16,8,6,6,7,27,43
Mozambique,SSA,c,2013,PF,4,3,6,10,7,0,0.0,23,12,7,8,9,36,59
Myanmar,Asia,c,2013,NF,6,5,3,6,3,3,0.0,9,7,4,1,5,17,26
Nagorno-Karabakh,Eurasia,t,2013,PF,5,5,4,5,3,0,0.0,12,6,3,5,5,19,31
Namibia,SSA,c,2013,F,2,2,10,11,9,0,0.0,30,14,12,11,9,46,76
Nauru,Asia,c,2013,F,1,1,12,16,10,0,0.0,38,15,11,15,14,55,93
Nepal,Asia,c,2013,PF,4,4,5,11,4,0,0.0,20,9,6,5,7,27,47
Netherlands,Europe,c,2013,F,1,1,12,16,12,0,0.0,40,16,12,15,16,59,99
New Zealand,Asia,c,2013,F,1,1,12,15,12,0,0.0,39,16,12,15,15,58,97
Nicaragua,Americas,c,2013,PF,5,4,6,7,4,0,0.0,17,12,6,7,9,34,51
Niger,SSA,c,2013,PF,3,4,9,10,7,0,0.0,26,11,8,5,6,30,56
Nigeria,SSA,c,2013,PF,4,4,6,9,5,0,0.0,20,9,7,4,6,26,46
North Korea,Asia,c,2013,NF,7,7,0,0,0,0,0.0,0,0,0,0,3,3,3
Northern Cyprus,Europe,t,2013,F,2,2,11,12,9,0,0.0,32,13,9,12,12,46,78
Norway,Europe,c,2013,F,1,1,12,16,12,0,0.0,40,16,12,16,16,60,100
Oman,MENA,c,2013,NF,6,5,2,2,2,0,3.0,9,5,3,4,5,17,26
Pakistan,Asia,c,2013,PF,4,5,6,9,5,0,0.0,20,5,7,4,6,22,42
Pakistani Kashmir,Asia,t,2013,NF,6,5,3,4,3,2,0.0,8,6,5,4,6,21,29
Palau,Asia,c,2013,F,1,1,12,15,10,0,0.0,37,16,11,15,13,55,92
Panama,Americas,c,2013,F,1,2,12,15,9,0,0.0,36,15,10,9,12,46,82
Papua New Guinea,Asia,c,2013,PF,4,3,9,10,4,0,0.0,23,12,9,7,8,36,59
Paraguay,Americas,c,2013,PF,3,3,10,12,5,0,0.0,27,11,8,6,10,35,62
Peru,Americas,c,2013,F,2,3,10,13,7,0,0.0,30,15,8,8,10,41,71
Philippines,Asia,c,2013,PF,3,3,9,10,7,0,0.0,26,14,8,5,10,37,63
Poland,Europe,c,2013,F,1,1,12,16,10,0,0.0,38,16,12,13,14,55,93
Portugal,Europe,c,2013,F,1,1,12,16,11,0,0.0,39,16,12,15,15,58,97
Puerto Rico,Americas,t,2013,F,1,2,12,15,10,0,0.0,37,16,10,12,14,52,89
Qatar,MENA,c,2013,NF,6,5,2,2,3,0,3.0,10,8,2,4,4,18,28
Romania,Europe,c,2013,F,2,2,10,14,8,0,0.0,32,14,11,12,12,49,81
Russia,Eurasia,c,2013,NF,6,5,1,3,3,0,0.0,7,6,4,3,7,20,27
Rwanda,SSA,c,2013,NF,6,6,2,2,4,0,0.0,8,4,2,3,7,16,24
Samoa,Asia,c,2013,F,2,2,9,13,10,0,0.0,32,14,10,13,12,49,81
San Marino,Europe,c,2013,F,1,1,12,16,12,0,0.0,40,16,12,16,16,60,100
Sao Tome and Principe,SSA,c,2013,F,2,2,11,14,9,0,0.0,34,15,10,12,10,47,81
Saudi Arabia,MENA,c,2013,NF,7,7,0,0,1,0,2.0,3,3,0,2,2,7,10
Senegal,SSA,c,2013,F,2,3,11,13,8,0,0.0,32,14,10,10,9,43,75
Serbia,Europe,c,2013,F,2,2,9,14,7,0,0.0,30,15,10,10,13,48,78
Seychelles,SSA,c,2013,PF,3,3,8,10,7,0,0.0,25,11,9,11,11,42,67
Sierra Leone,SSA,c,2013,F,2,3,10,12,8,0,0.0,30,13,8,9,10,40,70
Singapore,Asia,c,2013,PF,4,4,4,8,7,0,0.0,19,10,4,7,12,33,52
Slovakia,Europe,c,2013,F,1,1,12,15,10,0,0.0,37,16,12,13,14,55,92
Slovenia,Europe,c,2013,F,1,1,12,15,11,0,0.0,38,14,12,14,13,53,91
Solomon Islands,Asia,c,2013,PF,4,3,6,10,6,0,0.0,22,14,9,8,12,43,65
Somalia,SSA,c,2013,NF,7,7,0,0,0,0,0.0,0,1,0,0,1,2,2
Somaliland,SSA,t,2013,PF,4,5,5,10,6,0,0.0,21,7,5,7,6,25,46
South Africa,SSA,c,2013,F,2,2,12,14,8,0,0.0,34,15,11,10,11,47,81
South Korea,Asia,c,2013,F,1,2,11,15,10,0,0.0,36,14,11,13,12,50,86
South Ossetia,Eurasia,t,2013,NF,7,6,0,0,0,3,0.0,-3,4,0,1,3,8,5
South Sudan,SSA,c,2013,NF,6,5,4,5,2,0,0.0,11,8,4,3,5,20,31
Spain,Europe,c,2013,F,1,1,12,16,11,0,0.0,39,16,12,14,15,57,96
Sri Lanka,Asia,c,2013,PF,5,4,6,6,4,0,0.0,16,8,6,5,8,27,43
St. Kitts and Nevis,Americas,c,2013,F,1,1,12,16,10,0,0.0,38,15,12,12,14,53,91
St. Lucia,Americas,c,2013,F,1,1,12,16,11,0,0.0,39,16,12,12,14,54,93
St. Vincent and the Grenadines,Americas,c,2013,F,1,1,11,16,9,0,0.0,36,15,11,13,14,53,89
Sudan,SSA,c,2013,NF,7,7,2,3,1,4,0.0,2,3,1,0,1,5,7
Suriname,Americas,c,2013,F,2,2,12,13,8,0,0.0,33,15,11,8,10,44,77
Swaziland,SSA,c,2013,NF,7,5,0,1,0,0,0.0,1,8,3,5,4,20,21
Sweden,Europe,c,2013,F,1,1,12,16,12,0,0.0,40,16,12,16,16,60,100
Switzerland,Europe,c,2013,F,1,1,12,15,12,0,0.0,39,15,12,15,15,57,96
Syria,MENA,c,2013,NF,7,7,0,0,1,2,0.0,-1,2,0,0,4,6,5
Taiwan,Asia,c,2013,F,1,2,11,15,10,0,0.0,36,14,11,14,13,52,88
Tajikistan,Eurasia,c,2013,NF,6,6,2,4,2,0,0.0,8,5,4,3,4,16,24
Tanzania,SSA,c,2013,PF,3,3,9,12,7,0,0.0,28,11,7,11,9,38,66
Thailand,Asia,c,2013,PF,4,4,8,9,5,0,0.0,22,9,6,6,10,31,53
The Gambia,SSA,c,2013,NF,6,6,2,5,0,0,0.0,7,5,4,1,6,16,23
Tibet,Asia,t,2013,NF,7,7,0,0,1,3,0.0,-2,0,0,0,3,3,1
Timor-Leste,Asia,c,2013,PF,3,4,11,12,6,0,0.0,29,12,7,6,9,34,63
Togo,SSA,c,2013,PF,5,4,4,8,4,0,0.0,16,8,6,6,7,27,43
Tonga,Asia,c,2013,F,3,2,11,14,4,0,0.0,29,13,8,11,12,44,73
Transnistria,Eurasia,t,2013,NF,6,6,3,5,2,0,0.0,10,6,2,2,5,15,25
Trinidad and Tobago,Americas,c,2013,F,2,2,11,13,9,0,0.0,33,15,11,9,13,48,81
Tunisia,MENA,c,2013,PF,3,4,9,12,5,0,0.0,26,10,8,6,9,33,59
Turkey,Europe,c,2013,PF,3,4,11,10,7,0,0.0,28,9,7,7,10,33,61
Turkmenistan,Eurasia,c,2013,NF,7,7,0,1,0,0,0.0,1,2,0,1,3,6,7
Tuvalu,Asia,c,2013,F,1,1,12,15,10,0,0.0,37,16,12,15,14,57,94
Uganda,SSA,c,2013,PF,5,4,3,6,3,0,0.0,12,11,4,6,7,28,40
Ukraine,Eurasia,c,2013,PF,4,3,8,9,4,0,0.0,21,10,8,7,11,36,57
United Arab Emirates,MENA,c,2013,NF,6,6,1,2,2,0,3.0,8,4,2,4,4,14,22
United Kingdom,Europe,c,2013,F,1,1,12,16,12,0,0.0,40,15,12,15,15,57,97
United States,Americas,c,2013,F,1,1,11,16,10,0,0.0,37,16,11,14,15,56,93
Uruguay,Americas,c,2013,F,1,1,12,16,11,0,0.0,39,16,12,15,15,58,97
Uzbekistan,Eurasia,c,2013,NF,7,7,0,0,0,0,0.0,0,1,0,0,3,4,4
Vanuatu,Asia,c,2013,F,2,2,9,15,8,0,0.0,32,15,11,10,11,47,79
Venezuela,Americas,c,2013,PF,5,5,5,8,2,0,0.0,15,9,4,4,7,24,39
Vietnam,Asia,c,2013,NF,7,5,0,1,1,0,0.0,2,4,1,4,8,17,19
West Bank,MENA,t,2013,NF,6,5,2,5,2,3,0.0,6,8,6,5,5,24,30
Western Sahara,MENA,t,2013,NF,7,7,0,0,0,2,0.0,-2,3,0,0,4,7,5
Yemen,MENA,c,2013,NF,6,6,3,4,2,0,0.0,9,6,3,2,5,16,25
Zambia,SSA,c,2013,PF,3,4,9,12,7,0,0.0,28,11,7,8,8,34,62
Zimbabwe,SSA,c,2013,NF,6,6,3,5,3,0,0.0,11,6,3,1,4,14,25
