Country/Territory,Region,C/T?,Edition,Status,PR_Rating,CL_Rating,A,B,C,Add_Q,Add_A,PR,D,E,F,G,CL,Total
Abkhazia,Eurasia,t,2006,PF,5,5,5,5,3,0,0.0,13,8,4,4,5,21,34
Afghanistan,Asia,c,2006,PF,5,5,6,7,3,0,0.0,16,5,5,4,5,19,35
Albania,Europe,c,2006,PF,3,3,8,11,6,0,0.0,25,11,8,10,9,38,63
Algeria,MENA,c,2006,NF,6,5,5,3,3,0,0.0,11,8,6,4,7,25,36
Andorra,Europe,c,2006,F,1,1,12,15,12,0,0.0,39,16,11,15,15,57,96
Angola,SSA,c,2006,NF,6,5,2,5,1,0,0.0,8,8,6,4,3,21,29
Antigua and Barbuda,Americas,c,2006,F,2,2,11,12,7,0,0.0,30,13,9,12,13,47,77
Argentina,Americas,c,2006,F,2,2,11,15,8,0,0.0,34,15,11,11,13,50,84
Armenia,Eurasia,c,2006,PF,5,4,4,5,4,0,0.0,13,8,5,6,9,28,41
Australia,Asia,c,2006,F,1,1,12,15,12,0,0.0,39,16,12,14,15,57,96
Austria,Europe,c,2006,F,1,1,12,16,12,0,0.0,40,16,12,15,15,58,98
Azerbaijan,Eurasia,c,2006,NF,6,5,3,4,3,0,0.0,10,7,3,5,8,23,33
Bahamas,Americas,c,2006,F,1,1,12,16,10,0,0.0,38,16,12,15,15,58,96
Bahrain,MENA,c,2006,PF,5,5,3,6,5,0,0.0,14,8,5,4,5,22,36
Bangladesh,Asia,c,2006,PF,4,4,8,10,4,0,0.0,22,8,8,6,9,31,53
Barbados,Americas,c,2006,F,1,1,12,16,12,0,0.0,40,16,12,16,15,59,99
Belarus,Eurasia,c,2006,NF,7,6,1,3,1,0,0.0,5,3,0,2,5,10,15
Belgium,Europe,c,2006,F,1,1,12,15,12,0,0.0,39,16,12,15,15,58,97
Belize,Americas,c,2006,F,1,2,12,14,10,0,0.0,36,15,11,13,13,52,88
Benin,SSA,c,2006,F,2,2,8,14,8,0,0.0,30,15,11,12,10,48,78
Bhutan,Asia,c,2006,NF,6,5,2,1,5,1,2.0,9,6,2,4,8,20,29
Bolivia,Americas,c,2006,PF,3,3,10,13,5,0,0.0,28,15,11,8,9,43,71
Bosnia and Herzegovina,Europe,c,2006,PF,4,3,7,11,5,0,0.0,23,11,8,10,10,39,62
Botswana,SSA,c,2006,F,2,2,11,11,9,0,0.0,31,14,10,13,10,47,78
Brazil,Americas,c,2006,F,2,2,11,14,7,0,0.0,32,15,10,8,12,45,77
Brunei,Asia,c,2006,NF,6,5,0,3,2,0,1.0,6,6,3,6,8,23,29
Bulgaria,Europe,c,2006,F,1,2,12,15,9,0,0.0,36,14,11,13,13,51,87
Burkina Faso,SSA,c,2006,PF,5,3,5,8,4,0,0.0,17,13,9,6,8,36,53
Burundi,SSA,c,2006,PF,3,5,9,11,5,0,0.0,25,9,5,4,6,24,49
Cambodia,Asia,c,2006,NF,6,5,3,5,3,0,0.0,11,9,6,2,7,24,35
Cameroon,SSA,c,2006,NF,6,6,3,5,3,0,0.0,11,7,3,2,4,16,27
Canada,Americas,c,2006,F,1,1,12,16,11,0,0.0,39,16,12,15,16,59,98
Cape Verde,SSA,c,2006,F,1,1,12,15,10,0,0.0,37,15,11,14,13,53,90
Central African Republic,SSA,c,2006,PF,5,4,7,7,3,0,0.0,17,10,9,3,5,27,44
Chad,SSA,c,2006,NF,6,5,3,2,3,0,0.0,8,7,6,2,3,18,26
Chechnya,Eurasia,t,2006,NF,7,7,0,0,0,0,0.0,0,4,0,0,1,5,5
Chile,Americas,c,2006,F,1,1,12,15,12,0,0.0,39,16,12,15,14,57,96
China,Asia,c,2006,NF,7,6,0,1,1,0,0.0,2,4,2,2,7,15,17
Colombia,Americas,c,2006,PF,3,3,9,8,7,0,0.0,24,12,7,7,10,36,60
Comoros,SSA,c,2006,PF,4,4,7,8,3,0,0.0,18,10,6,8,6,30,48
Congo (Brazzaville),SSA,c,2006,PF,5,5,3,5,4,0,0.0,12,9,8,2,6,25,37
Congo (Kinshasa),SSA,c,2006,NF,6,6,1,5,2,0,0.0,8,6,5,0,1,12,20
Costa Rica,Americas,c,2006,F,1,1,12,15,11,0,0.0,38,16,11,14,13,54,92
Cote d'Ivoire,SSA,c,2006,NF,6,6,2,2,2,0,0.0,6,5,3,3,4,15,21
Croatia,Europe,c,2006,F,2,2,12,14,9,0,0.0,35,14,12,10,13,49,84
Cuba,Americas,c,2006,NF,7,7,0,0,1,0,0.0,1,2,2,1,2,7,8
Cyprus,Europe,c,2006,F,1,1,11,16,11,0,0.0,38,15,12,15,15,57,95
Czech Republic,Europe,c,2006,F,1,1,12,15,10,0,0.0,37,16,12,13,14,55,92
Denmark,Europe,c,2006,F,1,1,12,16,12,0,0.0,40,16,12,15,15,58,98
Djibouti,SSA,c,2006,PF,5,5,4,5,3,0,0.0,12,7,5,5,6,23,35
Dominica,Americas,c,2006,F,1,1,12,16,10,0,0.0,38,16,12,13,13,54,92
Dominican Republic,Americas,c,2006,F,2,2,11,13,8,0,0.0,32,15,11,9,11,46,78
Ecuador,Americas,c,2006,PF,3,3,8,15,4,0,0.0,27,15,11,5,10,41,68
Egypt,MENA,c,2006,NF,6,5,2,4,2,0,0.0,8,7,3,5,7,22,30
El Salvador,Americas,c,2006,F,2,3,12,13,7,0,0.0,32,15,10,8,10,43,75
Equatorial Guinea,SSA,c,2006,NF,7,6,0,1,0,0,0.0,1,5,0,1,3,9,10
Eritrea,SSA,c,2006,NF,7,6,0,1,2,0,0.0,3,2,0,3,6,11,14
Estonia,Europe,c,2006,F,1,1,12,15,12,0,0.0,39,16,12,14,14,56,95
Ethiopia,SSA,c,2006,PF,5,5,5,6,4,0,0.0,15,7,3,5,6,21,36
Fiji,Asia,c,2006,PF,4,3,6,8,6,0,0.0,20,12,9,11,10,42,62
Finland,Europe,c,2006,F,1,1,12,16,12,0,0.0,40,16,12,16,16,60,100
France,Europe,c,2006,F,1,1,12,15,11,0,0.0,38,15,12,13,15,55,93
Gabon,SSA,c,2006,PF,6,4,2,5,3,0,0.0,10,11,6,7,6,30,40
Georgia,Eurasia,c,2006,PF,3,3,9,9,6,0,0.0,24,11,8,8,10,37,61
Germany,Europe,c,2006,F,1,1,12,15,12,0,0.0,39,16,12,15,15,58,97
Ghana,SSA,c,2006,F,1,2,12,15,10,0,0.0,37,14,11,12,10,47,84
Greece,Europe,c,2006,F,1,2,12,15,10,0,0.0,37,15,10,13,13,51,88
Grenada,Americas,c,2006,F,1,2,12,16,9,0,0.0,37,15,9,12,14,50,87
Guatemala,Americas,c,2006,PF,4,4,9,8,5,0,0.0,22,12,8,5,8,33,55
Guinea,SSA,c,2006,NF,6,5,2,5,2,0,0.0,9,8,5,4,6,23,32
Guinea-Bissau,SSA,c,2006,PF,3,4,9,10,6,0,0.0,25,12,8,8,6,34,59
Guyana,Americas,c,2006,PF,3,3,10,12,7,0,0.0,29,15,10,7,9,41,70
Haiti,Americas,c,2006,NF,7,6,0,5,0,0,0.0,5,8,3,0,5,16,21
Honduras,Americas,c,2006,PF,3,3,9,11,6,0,0.0,26,14,9,8,9,40,66
Hong Kong,Asia,t,2006,PF,5,2,3,7,6,0,0.0,16,14,10,14,13,51,67
Hungary,Europe,c,2006,F,1,1,12,15,10,0,0.0,37,16,12,14,14,56,93
Iceland,Europe,c,2006,F,1,1,12,16,12,0,0.0,40,16,12,16,16,60,100
India,Asia,c,2006,F,2,3,11,14,9,0,0.0,34,13,10,9,10,42,76
Indian Kashmir,Asia,t,2006,PF,5,5,6,6,3,0,0.0,15,8,6,3,8,25,40
Indonesia,Asia,c,2006,F,2,3,11,13,6,0,0.0,30,11,9,7,8,35,65
Iran,MENA,c,2006,NF,6,6,3,3,3,0,0.0,9,5,3,3,4,15,24
Iraq,MENA,c,2006,NF,6,5,3,4,2,0,0.0,9,6,5,2,6,19,28
Ireland,Europe,c,2006,F,1,1,12,16,12,0,0.0,40,16,12,15,15,58,98
Israel,MENA,c,2006,F,1,2,12,15,10,0,0.0,37,14,11,10,11,46,83
Israeli Occupied Territories,MENA,t,2006,NF,6,5,2,2,3,1,0.0,6,6,5,2,5,18,24
Italy,Europe,c,2006,F,1,1,12,16,11,0,0.0,39,14,12,12,15,53,92
Jamaica,Americas,c,2006,F,2,3,10,13,8,0,0.0,31,15,9,8,11,43,74
Japan,Asia,c,2006,F,1,2,12,15,10,0,0.0,37,13,10,15,13,51,88
Jordan,MENA,c,2006,PF,5,4,4,7,4,0,0.0,15,8,5,7,7,27,42
Kazakhstan,Eurasia,c,2006,NF,6,5,3,4,3,0,0.0,10,7,4,4,7,22,32
Kenya,SSA,c,2006,PF,3,3,9,11,6,0,0.0,26,14,9,8,9,40,66
Kiribati,Asia,c,2006,F,1,1,12,16,10,0,0.0,38,15,12,15,13,55,93
Kosovo,Eurasia,t,2006,PF,6,5,5,5,3,0,3.0,10,6,6,2,5,19,29
Kuwait,MENA,c,2006,PF,4,5,4,8,6,0,0.0,18,9,5,7,4,25,43
Kyrgyzstan,Eurasia,c,2006,PF,5,4,5,7,4,0,0.0,16,11,8,5,7,31,47
Laos,Asia,c,2006,NF,7,6,0,1,0,0,0.0,1,4,1,2,5,12,13
Latvia,Europe,c,2006,F,1,1,12,15,9,0,0.0,36,16,12,12,13,53,89
Lebanon,MENA,c,2006,PF,5,4,4,8,4,0,0.0,16,11,7,5,7,30,46
Lesotho,SSA,c,2006,F,2,3,10,12,9,0,0.0,31,15,8,11,9,43,74
Liberia,SSA,c,2006,PF,4,4,9,10,4,0,0.0,23,11,7,7,8,33,56
Libya,MENA,c,2006,NF,7,7,0,1,0,0,0.0,1,1,0,0,5,6,7
Liechtenstein,Europe,c,2006,F,1,1,12,16,12,0,0.0,40,16,12,16,15,59,99
Lithuania,Europe,c,2006,F,1,1,12,15,9,0,0.0,36,16,11,14,13,54,90
Luxembourg,Europe,c,2006,F,1,1,12,16,12,0,0.0,40,16,12,16,16,60,100
Macedonia,Europe,c,2006,PF,3,3,8,10,7,0,0.0,25,11,7,8,10,36,61
Madagascar,SSA,c,2006,PF,3,3,8,9,7,0,0.0,24,10,8,9,9,36,60
Malawi,SSA,c,2006,PF,4,4,7,10,6,0,0.0,23,11,8,8,7,34,57
Malaysia,Asia,c,2006,PF,4,4,6,7,6,0,0.0,19,10,6,6,9,31,50
Maldives,Asia,c,2006,NF,6,5,3,2,4,0,0.0,9,6,3,6,7,22,31
Mali,SSA,c,2006,F,2,2,9,12,9,0,0.0,30,15,9,11,9,44,74
Malta,Europe,c,2006,F,1,1,12,16,11,0,0.0,39,16,12,16,15,59,98
Marshall Islands,Asia,c,2006,F,1,1,12,15,10,0,0.0,37,16,11,15,13,55,92
Mauritania,SSA,c,2006,PF,6,4,2,6,3,0,0.0,11,10,6,6,5,27,38
Mauritius,SSA,c,2006,F,1,1,12,15,11,0,0.0,38,15,12,14,12,53,91
Mexico,Americas,c,2006,F,2,2,12,14,9,0,0.0,35,15,10,8,12,45,80
Micronesia,Asia,c,2006,F,1,1,12,15,10,0,0.0,37,16,11,15,14,56,93
Moldova,Eurasia,c,2006,PF,3,4,9,8,7,0,0.0,24,10,6,8,9,33,57
Monaco,Europe,c,2006,F,2,1,10,11,10,0,0.0,31,15,12,15,14,56,87
Mongolia,Asia,c,2006,F,2,2,9,15,10,0,0.0,34,15,10,12,12,49,83
Morocco,MENA,c,2006,PF,5,4,4,7,6,0,0.0,17,8,6,4,8,26,43
Mozambique,SSA,c,2006,PF,3,4,7,11,7,0,0.0,25,10,7,6,8,31,56
Myanmar,Asia,c,2006,NF,7,7,0,1,0,2,0.0,-1,2,0,0,4,6,5
Nagorno-Karabakh,Eurasia,t,2006,PF,5,5,6,5,3,0,0.0,14,8,4,4,5,21,35
Namibia,SSA,c,2006,F,2,2,10,12,9,0,0.0,31,15,12,10,9,46,77
Nauru,Asia,c,2006,F,1,1,12,16,10,0,0.0,38,15,11,15,14,55,93
Nepal,Asia,c,2006,NF,6,5,1,6,2,0,0.0,9,6,3,4,6,19,28
Netherlands,Europe,c,2006,F,1,1,12,16,12,0,0.0,40,16,12,15,16,59,99
New Zealand,Asia,c,2006,F,1,1,12,15,12,0,0.0,39,16,11,15,15,57,96
Nicaragua,Americas,c,2006,PF,3,3,9,11,5,0,0.0,25,13,8,7,10,38,63
Niger,SSA,c,2006,PF,3,3,10,10,7,0,0.0,27,11,7,10,7,35,62
Nigeria,SSA,c,2006,PF,4,4,6,8,6,0,0.0,20,11,7,4,6,28,48
North Korea,Asia,c,2006,NF,7,7,0,0,0,0,0.0,0,0,0,0,0,0,0
Northern Cyprus,Europe,t,2006,F,2,2,11,14,9,0,0.0,34,13,9,12,12,46,80
Norway,Europe,c,2006,F,1,1,12,16,12,0,0.0,40,16,12,16,16,60,100
Oman,MENA,c,2006,NF,6,5,2,2,2,0,4.0,10,6,4,3,5,18,28
Pakistan,Asia,c,2006,NF,6,5,2,6,3,0,0.0,11,8,6,4,6,24,35
Pakistani Kashmir,Asia,t,2006,NF,7,5,2,3,2,2,0.0,5,6,4,4,6,20,25
Palau,Asia,c,2006,F,1,1,12,15,10,0,0.0,37,16,11,15,13,55,92
Palestinian Authority Administered Territories,MENA,t,2006,PF,5,5,5,7,4,0,0.0,16,5,5,2,5,17,33
Panama,Americas,c,2006,F,1,2,12,15,9,0,0.0,36,15,11,9,12,47,83
Papua New Guinea,Asia,c,2006,PF,3,3,9,11,6,0,0.0,26,12,9,9,8,38,64
Paraguay,Americas,c,2006,PF,3,3,11,11,3,0,0.0,25,13,8,7,10,38,63
Peru,Americas,c,2006,F,2,3,11,14,7,0,0.0,32,15,10,8,9,42,74
Philippines,Asia,c,2006,PF,3,3,7,14,8,0,0.0,29,15,9,9,10,43,72
Poland,Europe,c,2006,F,1,1,12,16,10,0,0.0,38,16,12,13,13,54,92
Portugal,Europe,c,2006,F,1,1,12,16,12,0,0.0,40,16,12,15,14,57,97
Puerto Rico,Americas,t,2006,F,1,1,12,15,10,0,0.0,37,16,11,14,14,55,92
Qatar,MENA,c,2006,NF,6,5,2,1,3,0,3.0,9,8,2,4,4,18,27
Romania,Europe,c,2006,F,2,2,10,13,7,0,0.0,30,13,10,11,11,45,75
Russia,Eurasia,c,2006,NF,6,5,3,5,3,0,0.0,11,8,6,4,6,24,35
Rwanda,SSA,c,2006,NF,6,5,3,3,5,0,0.0,11,7,3,6,5,21,32
Samoa,Asia,c,2006,F,2,2,9,13,10,0,0.0,32,14,10,13,12,49,81
San Marino,Europe,c,2006,F,1,1,12,16,12,0,0.0,40,16,12,16,16,60,100
Sao Tome and Principe,SSA,c,2006,F,2,2,11,14,8,0,0.0,33,15,10,12,10,47,80
Saudi Arabia,MENA,c,2006,NF,7,6,0,0,1,0,3.0,4,4,0,2,2,8,12
Senegal,SSA,c,2006,F,2,3,12,12,9,0,0.0,33,15,9,10,9,43,76
Serbia and Montenegro,Europe,c,2006,F,3,2,9,13,7,0,0.0,29,14,11,9,13,47,76
Seychelles,SSA,c,2006,PF,3,3,8,11,7,0,0.0,26,11,9,11,11,42,68
Sierra Leone,SSA,c,2006,PF,4,3,9,10,4,0,0.0,23,12,8,8,9,37,60
Singapore,Asia,c,2006,PF,5,4,4,6,7,0,0.0,17,9,4,8,12,33,50
Slovakia,Europe,c,2006,F,1,1,12,15,10,0,0.0,37,16,12,12,14,54,91
Slovenia,Europe,c,2006,F,1,1,12,15,11,0,0.0,38,16,12,14,12,54,92
Solomon Islands,Asia,c,2006,PF,3,3,7,10,7,0,0.0,24,13,9,8,12,42,66
Somalia,SSA,c,2006,NF,6,7,0,4,4,0,0.0,8,3,1,3,0,7,15
South Africa,SSA,c,2006,F,1,2,12,14,10,0,0.0,36,15,12,13,12,52,88
South Korea,Asia,c,2006,F,1,2,11,15,10,0,0.0,36,14,12,12,11,49,85
Spain,Europe,c,2006,F,1,1,12,14,12,0,0.0,38,16,12,14,15,57,95
Sri Lanka,Asia,c,2006,PF,3,3,8,9,7,0,0.0,24,9,9,7,10,35,59
St. Kitts and Nevis,Americas,c,2006,F,1,1,12,16,10,0,0.0,38,15,12,12,14,53,91
St. Lucia,Americas,c,2006,F,1,1,12,16,10,0,0.0,38,15,12,12,14,53,91
St. Vincent and the Grenadines,Americas,c,2006,F,2,1,9,15,8,0,0.0,32,15,11,13,14,53,85
Sudan,SSA,c,2006,NF,7,7,0,4,1,4,0.0,1,4,1,0,1,6,7
Suriname,Americas,c,2006,F,2,2,12,13,8,0,0.0,33,15,11,9,10,45,78
Swaziland,SSA,c,2006,NF,7,5,0,1,0,0,0.0,1,8,3,4,5,20,21
Sweden,Europe,c,2006,F,1,1,12,16,12,0,0.0,40,16,12,16,16,60,100
Switzerland,Europe,c,2006,F,1,1,12,16,12,0,0.0,40,16,12,15,16,59,99
Syria,MENA,c,2006,NF,7,7,0,0,1,0,0.0,1,2,0,1,4,7,8
Taiwan,Asia,c,2006,F,1,1,11,15,10,0,0.0,36,16,11,15,13,55,91
Tajikistan,Eurasia,c,2006,NF,6,5,2,4,3,0,0.0,9,7,4,4,6,21,30
Tanzania,SSA,c,2006,PF,4,3,6,10,6,0,0.0,22,11,7,10,8,36,58
Thailand,Asia,c,2006,PF,3,3,9,12,8,0,0.0,29,11,8,8,11,38,67
The Gambia,SSA,c,2006,PF,5,4,6,7,4,0,0.0,17,10,6,8,8,32,49
Tibet,Asia,t,2006,NF,7,7,0,0,1,3,0.0,-2,0,0,0,5,5,3
Timor-Leste,Asia,c,2006,PF,3,3,11,10,8,0,0.0,29,13,8,8,9,38,67
Togo,SSA,c,2006,NF,6,5,2,3,2,0,0.0,7,7,3,1,7,18,25
Tonga,Asia,c,2006,PF,5,3,3,9,3,0,0.0,15,12,7,12,11,42,57
Transnistria,Eurasia,t,2006,NF,6,6,2,3,1,0,0.0,6,6,2,2,5,15,21
Trinidad and Tobago,Americas,c,2006,F,3,2,9,11,8,0,0.0,28,14,11,10,11,46,74
Tunisia,MENA,c,2006,NF,6,5,1,3,2,0,0.0,6,4,2,4,8,18,24
Turkey,Europe,c,2006,PF,3,3,9,12,7,0,0.0,28,12,7,8,10,37,65
Turkmenistan,Eurasia,c,2006,NF,7,7,0,0,0,0,0.0,0,1,0,0,0,1,1
Tuvalu,Asia,c,2006,F,1,1,12,15,10,0,0.0,37,16,12,15,14,57,94
Uganda,SSA,c,2006,PF,5,4,3,6,5,0,0.0,14,11,6,7,7,31,45
Ukraine,Eurasia,c,2006,F,3,2,8,12,7,0,0.0,27,13,10,11,11,45,72
United Arab Emirates,MENA,c,2006,NF,6,6,0,1,2,0,4.0,7,6,1,4,4,15,22
United Kingdom,Europe,c,2006,F,1,1,12,15,12,0,0.0,39,16,12,14,15,57,96
United States,Americas,c,2006,F,1,1,10,16,11,0,0.0,37,16,11,14,15,56,93
Uruguay,Americas,c,2006,F,1,1,12,16,11,0,0.0,39,16,12,15,15,58,97
Uzbekistan,Eurasia,c,2006,NF,7,7,0,0,0,0,0.0,0,1,0,0,2,3,3
Vanuatu,Asia,c,2006,F,2,2,9,15,8,0,0.0,32,16,11,10,11,48,80
Venezuela,Americas,c,2006,PF,4,4,10,8,5,0,0.0,23,11,7,5,8,31,54
Vietnam,Asia,c,2006,NF,7,5,0,1,1,0,0.0,2,3,2,4,8,17,19
Western Sahara,MENA,t,2006,NF,7,6,0,0,0,2,0.0,-2,3,2,0,5,10,8
Yemen,MENA,c,2006,PF,5,5,4,6,3,0,0.0,13,7,3,3,5,18,31
Zambia,SSA,c,2006,PF,4,4,5,11,6,0,0.0,22,11,8,8,7,34,56
Zimbabwe,SSA,c,2006,NF,7,6,1,4,0,0,0.0,5,5,3,1,1,10,15
